00004000000000000000
00004000000000000000
00040000111000000000
00040000101100000000
00400000100110000000
00000000100310000000
00000000111110000000
00000000001000000000
00000000001000000000
00000000001000000000
00000000000000330000
20000000000000333000
22220000000000033000
22222220000000003000
22222222000000000000