11115111111111111111
11115111111111111111
11151111222111111111
11151111212211111111
11511111211221111111
11111111211421111111
11111111222221111111
11111111112111111111
11111111112111111111
11111111112111111111
11111111111111441111
31111111111111444111
33331111111111144111
33333331111111114111
33333333111111111111