3333333333333333
3333339493333333
333333@4@3333333
3333334443333333
3333332723333333
3333332623333333
333g2226222b3333
33d126666621c333
3a22265556222z33
33d11@151@11c333
333f@1@3@1@v3333
3333333333333333