3333333333333333
3333333333333333
33152272215c1c33
311525412@11zc33
3@@2233321612c33
311213331@6@2133
3d22s33522222@33
3da1111551337333
33dd111111331133
33336@65#171@@33
3333333333333333
3333333333333333